1111111111111111111
1000P000C0001000001
1C00010000000000001
100E0001000100000C1
1111111111111111111
